{
    "width": 50,
    "height": 20,
    "tileWidth": 64,
    "tileHeight": 64,
    "tileSize": 64,
    "snakeSpawnX": 20,
    "snakeSpawnY": 9, 
    "victimSpawns": [{"x": 7, "y": 5}, {"x": 5, "y": 10}, {"x": 5, "y": 15}, {"x": 10, "y": 5}, {"x": 10, "y": 10}, {"x": 10, "y": 15}, {"x": 30, "y": 5}, {"x": 30, "y": 10}, {"x": 30, "y": 15}, {"x": 35, "y": 10}, {"x": 35, "y": 5}, {"x": 35, "y": 10}, {"x": 40, "y": 17}, {"x": 40, "y": 10}, {"x": 40, "y": 15}, {"x": 8, "y": 8}, {"x": 11, "y": 6}, {"x": 11, "y": 16}, {"x": 11, "y": 18}],
    "enemySpawns":  [{"x": 6, "y": 10}, {"x": 6, "y": 15}, {"x": 11, "y": 5}, {"x": 11, "y": 15}, {"x": 31, "y": 5}, {"x": 31, "y": 10}, {"x": 31, "y": 15}, {"x": 41, "y": 5}, {"x": 41, "y": 10}],
    "tileSet": [{"collision": false, "image": "../img/tiles/grass2.png"}, {"collision": true, "image": "../img/tiles/rock1.png"}, {"collision": false, "image": "../img/tiles/bush1.png"}, {"collision": true, "image": "../img/tiles/rock0.png"}],
    "data":[1, 1, 1, 1, 1, 1, 1, 1, 1, 1, 1, 1, 1, 1, 1, 1, 1, 1, 1, 1, 1, 1, 1, 1, 1, 1, 1, 1, 1, 1, 1, 1, 1, 1, 1, 1, 1, 1, 1, 1, 1, 1, 1, 1, 1, 1, 1, 1, 1, 1,
            1, 0, 3, 0, 2, 0, 0, 2, 2, 2, 0, 0, 0, 3, 0, 0, 0, 0, 2, 0, 0, 3, 0, 0, 2, 0, 0, 0, 0, 0, 3, 3, 0, 0, 2, 2, 2, 2, 0, 0, 0, 0, 3, 0, 2, 2, 2, 2, 2, 1,
            1, 0, 0, 0, 0, 2, 0, 0, 2, 0, 0, 2, 0, 0, 0, 0, 3, 0, 0, 0, 0, 0, 0, 0, 0, 0, 0, 0, 0, 0, 0, 0, 0, 0, 0, 2, 0, 0, 0, 0, 0, 2, 0, 0, 2, 3, 0, 2, 2, 1,
            1, 0, 0, 0, 3, 0, 0, 2, 0, 0, 2, 0, 0, 0, 0, 0, 3, 0, 0, 0, 0, 0, 0, 0, 0, 0, 0, 0, 0, 0, 0, 2, 0, 0, 0, 3, 0, 0, 0, 0, 0, 0, 0, 0, 0, 3, 0, 2, 2, 1,
            1, 0, 0, 0, 2, 2, 0, 0, 0, 2, 0, 3, 0, 0, 2, 0, 0, 0, 3, 0, 0, 0, 2, 0, 0, 0, 3, 0, 0, 2, 3, 2, 2, 0, 0, 0, 0, 2, 0, 3, 0, 0, 0, 3, 0, 0, 0, 3, 0, 1,
            1, 0, 0, 0, 3, 2, 0, 3, 0, 0, 2, 2, 0, 0, 2, 0, 2, 0, 0, 0, 3, 0, 0, 0, 0, 0, 0, 0, 2, 3, 3, 0, 0, 0, 0, 0, 0, 0, 0, 0, 0, 0, 0, 0, 0, 0, 0, 0, 0, 1,
            1, 0, 0, 0, 0, 0, 0, 0, 0, 0, 0, 0, 0, 0, 0, 0, 0, 0, 0, 0, 0, 0, 0, 3, 0, 0, 0, 2, 0, 3, 3, 0, 0, 0, 2, 0, 0, 0, 0, 0, 0, 0, 0, 0, 0, 0, 0, 0, 0, 1,
            1, 0, 0, 0, 0, 2, 0, 0, 0, 0, 0, 2, 0, 0, 0, 0, 2, 0, 0, 0, 0, 0, 0, 0, 0, 0, 0, 0, 2, 0, 0, 2, 2, 2, 0, 2, 0, 0, 0, 0, 0, 0, 2, 0, 0, 0, 0, 0, 0, 1,
            1, 0, 0, 2, 0, 3, 0, 0, 0, 2, 0, 0, 0, 3, 2, 0, 0, 0, 0, 0, 0, 0, 0, 0, 0, 0, 0, 2, 0, 0, 2, 2, 2, 3, 0, 0, 3, 0, 0, 0, 0, 3, 0, 0, 0, 0, 0, 0, 2, 1,
            1, 3, 0, 2, 0, 0, 0, 0, 0, 2, 0, 0, 0, 0, 2, 0, 0, 3, 3, 2, 3, 0, 3, 0, 0, 0, 0, 2, 2, 2, 0, 2, 2, 3, 3, 0, 0, 0, 0, 0, 2, 0, 0, 0, 0, 3, 0, 0, 0, 1,
            1, 0, 0, 0, 2, 2, 0, 0, 0, 0, 2, 2, 2, 0, 3, 2, 0, 0, 0, 2, 0, 0, 0, 2, 0, 3, 0, 0, 0, 0, 2, 0, 0, 0, 0, 0, 0, 0, 0, 0, 0, 0, 0, 0, 0, 0, 0, 0, 0, 1,
            1, 0, 0, 0, 3, 0, 3, 2, 0, 3, 0, 0, 0, 0, 0, 0, 0, 0, 0, 0, 0, 0, 0, 0, 0, 3, 3, 0, 0, 0, 0, 2, 0, 0, 0, 0, 0, 2, 0, 0, 0, 0, 0, 0, 3, 0, 0, 0, 0, 1,
            1, 0, 0, 0, 0, 0, 0, 0, 2, 0, 0, 0, 0, 0, 0, 0, 0, 0, 0, 0, 0, 0, 0, 0, 0, 3, 3, 3, 2, 0, 0, 0, 3, 0, 0, 0, 3, 0, 0, 3, 0, 0, 0, 2, 0, 0, 0, 3, 0, 1,
            1, 3, 2, 0, 0, 0, 0, 0, 0, 2, 0, 0, 2, 0, 2, 0, 0, 0, 0, 0, 0, 0, 0, 2, 0, 3, 0, 0, 0, 0, 0, 0, 0, 0, 0, 0, 0, 0, 0, 0, 0, 0, 3, 0, 0, 0, 0, 0, 2, 1,
            1, 0, 0, 2, 0, 0, 0, 0, 3, 2, 0, 0, 0, 2, 2, 2, 0, 0, 0, 3, 0, 0, 0, 0, 0, 3, 2, 0, 3, 2, 0, 0, 2, 0, 0, 0, 0, 0, 0, 0, 2, 0, 0, 0, 0, 2, 0, 0, 0, 1,
            1, 0, 0, 0, 2, 2, 0, 0, 0, 0, 2, 2, 0, 0, 2, 0, 0, 0, 2, 0, 0, 0, 0, 0, 0, 0, 0, 0, 0, 0, 0, 0, 0, 0, 0, 0, 0, 3, 0, 0, 0, 0, 0, 0, 0, 0, 0, 0, 0, 1,
            1, 0, 0, 0, 0, 2, 0, 0, 2, 0, 0, 0, 0, 0, 0, 0, 0, 0, 0, 0, 3, 0, 0, 3, 0, 0, 0, 0, 0, 0, 3, 0, 2, 0, 0, 0, 0, 0, 0, 0, 0, 0, 3, 0, 0, 0, 0, 3, 2, 1,
            1, 0, 0, 0, 0, 0, 3, 0, 0, 0, 0, 0, 0, 0, 3, 0, 0, 0, 0, 0, 0, 0, 0, 0, 2, 0, 0, 0, 0, 0, 0, 3, 0, 0, 0, 3, 0, 0, 0, 0, 0, 0, 0, 0, 0, 2, 3, 0, 0, 1,
            1, 3, 3, 0, 0, 0, 0, 0, 0, 0, 3, 0, 3, 2, 0, 0, 0, 0, 2, 0, 0, 0, 0, 0, 0, 0, 0, 3, 0, 0, 0, 0, 0, 0, 0, 0, 0, 0, 0, 3, 0, 2, 0, 2, 0, 2, 2, 0, 0, 1,
            1, 1, 1, 1, 1, 1, 1, 1, 1, 1, 1, 1, 1, 1, 1, 1, 1, 1, 1, 1, 1, 1, 1, 1, 1, 1, 1, 1, 1, 1, 1, 1, 1, 1, 1, 1, 1, 1, 1, 1, 1, 1, 1, 1, 1, 1, 1, 1, 1, 1]
}